NO      ./sprites/wall_lvl0.xpm
SO    ./sprites/wall_lvl0.xpm
WE ./sprites/wall_lvl0.xpm
EA              ./sprites/wall_lvl0.xpm

F 125,107,87
C 6,22,39

11111111111111111111111111
10000100000000000000100001
10000100000000000000100001
1111110000000000E000100001
10000000000000000000100001
10000000010000000000000001
10000000000000000000000001
10000000000000000000000001
11111111111111111111111111
