NO      ./sprites/wall_lvl2.xpm
SO    ./sprites/wall_lvl3.xpm
WE ./sprites/wall_lvl1.xpm
EA              ./sprites/wall_lvl0.xpm

F 125,107,87
C 6,22,39

11111111111111111111111111
10000000000000000000100001
10000000000000000000100001
1000000S00000000E000100001
10000000000000000000100001
10000000010000000000000001
10000000000000000000000001
10000000000000000000000001
11111111111111111111111111
