111111
101001
101001
1100N1
111111