
NO      ./sprites/wall_lvl3.xpm
SO    ./sprites/wall_lvl2.xpm
WE ./sprites/wall_lvl1.xpm
EA              ./sprites/wall_lvl0.xpm

F 125,107,87
C 6,22,39
        11111111111111111111111111
        10000000001100000000000001
        10110000011100000000000011
        10010000000000000000000001
111111111011000001110000000000001
100000000011000001110111110111111
11110111111111111111011111111
11110111111111011100000010001
11110111111111011101010010001
11000000110101011100000010001
10000000000000011000W00100011
10000000000000001101010100001
110000011101010111110111100011
11110111 1110101 101111010011
11111111 1111111 111111111111
