
C  6,22,3
F  125,107,87

NO      ./sprites/wall_lvl3.xpm         
SO    ./sprites/wall_lvl2.xpm    
EA             ./sprites/wall_lvl0.xpm 
WE ./sprites/wall_lvl1.xpm  

        111111111111111111111


                  0 0      0


        100000000011000000001
        01100000111000000011
        100100000000000000001
11111111101100000111000000001

100000000011000001110111110111
11111111111111111111111101111
1000011111111011100000010001
11110111111111011101010010001
11000000110101011100000010001
100000S000000000100000100011
10000000000000001101010100001
110000011101010111110111100011
11110111 1110101     101111010011
11111111 1111111 1              0000000000000000000000              11111111111
0000000000000011
1111111111111000011111111111
000000000000000000000
111111111110000111111
1111111100000111111111111110000001111
1111110000000000000000001111111100001111
                                                                                      10