NO      ./sprites/greystone.xpm
SO    ./sprites/colorstone.xpm
WE ./sprites/wood.xpm
EA              ./sprites/mossy.xpm

F 105,105,105
C 105,105,105

        1111111111111111111111111
        1000000000110000000000001
        1011000001110000000000001
        10010000000000000S0000001
111111111011000001110000000000001
100000000011000001110111110111111
11110111111111011100000010001
11110111111111011101010010001
11000000110101011100000010001
10000000000000001100000010001
10000000000000001101010010001
11000001110101011111011110001
11110111 1110101 101111110001
11111111 1111111 111111111111




