NO      ./sprites/greystone.xpm
SO    ./sprites/colorstone.xpm
WE ./sprites/wood.xpm
EA              ./sprites/redbrick.xpm

F 105,105,105
C 105,255,255


1111
1N1
11
1111